NO ./textures/north.png
SO ./textures/south.png
WE ./textures/west.png
EA ./textures/east.png

F 300,100,0
C 0,128,255

1111111
1000001
100N001
1000001
1111111