NO ./textures/north.png
SO ./textures/south.png
WE ./textures/west.png
EA ./textures/east.png

F 220,100,0
C 255,255,255

11111111111111
10000110000001
10000110000001
10000110000001
11111100011111
10000000000001
10000N0000001
10000000000001
11111100011111
10000110000001
10000110000001
11111111111111