NO ./textures/north.png
SO ./textures/south.png
WE ./textures/west.png
EA ./textures/east.png

F 220,100,0
C 255,255,255

1111111111111111111111111
1000000000111111111111111
1111111111111111111111111
1011000001110000000000001
100100000000000000000000111111111
111111111011000001110000000000001
1000000000110000011100111111111111
111101111111110111000000100011
11110111111111011101011000001
1100000011010101110001S100001
10000000000000001100001000001
10000000000000001101010010001
11000001111111111111011110001
11110111         101111010001
11111111         111111111111