NO ./textures/north.png
SO ./textures/south.png
WE ./textures/west.png
EA ./textures/east.png

F 220,100,0
C 255,255,255


1111111111111111111111111111111111111111
1000000000000000010010010000000000000001
1000000000000000000000000000000000000011
10001111111000111111111111111111111111001
1000000000000000000000000000000000000001
1001011111111000111001111000111111001001
1001011111111111111001111111111111000001
1001011000000000000000000000000001001001
1001011011111100011100011110001101001001
1001011011111111111110111111111101001001
1001111011000000000000000000000101001001
1001011011011110111111111011100101001001
1001011011010000000000000000100101001001
1001011011010000000000000000100101001001
1001111011010011111100011100100101000001
1001011011010010000000000100100101001001
1000011000010010010101100100100101001001
1001011011010010010101100100100101001001
1001011011010010010110100100100101001001
1001011011010010010100100100100101001101
1000011000010011010110100100100101000001
1001011011010010010110100100100101001001
1001011011011110010110111100100101001001
1001011011000001010110010000100101001001
1000011011100000010110000000100101000101
1001011011111111110111111111100101001001
1001011000000000000000000000000101001001
1001011111110011110100000000000101001001
1001011111110011110111111111111101001001
1001000000000000010100000000000001001001
1001100111111110010110111111111111001001
1000000000000110110011000000000000000001
1000000000000010000110110000000000001001
1110011110111110010110111100111111111001
1000000001000000010110000000000000000001
100000N00000000001010000000000000100001
1111111111111111111111111111111111111111