NO ./textures/north.png
SO ./textures/south.png
WE ./textures/west.png
EA ./textures/east.png

F 220,100,0
C 255,255,255


1111111111111111
10E0000000000001
1000000000000001
1001111001111001
1000001000000001
1111001111100111
1000000000000001
1000000000000001
1001111111111111
1000000000000111
1100000000000001
1000000111100001
1111111111111111
