NO ./textures/north.png
SO ./textures/south.png
WE ./textures/west.png
EA ./textures/east.png

F 220,100,0
C 255,255,255


1111111111111
1000000000101
10N0001000001
1001100111001
1000100000001
1110010111001
1000001000011
1001111100111
1000000000001
1111111111111