NO ./textures/north.png
SO ./textures/south.png
WE ./textures/west.png
EA ./textures/east.png

F 220,100,0
C 255,255,255


11111111111111111111111111111111111111111111111111111111
1001000000E000000000000000000000000000000000000000000001
10000000000000000101111111111100000000000000000000000001
 111000000000000001           10010000100000000100010001
    100111000000001            100100001000000100010001
 111000000000000000111111       1001000010000100010001
10000100011111100100000001       10010000100100010001
 1111000000000000100000001        100100001000010001
     10011111110000011111          1001000000010001
 1111000000000000001                11010000010001
10000100011111100001                 100100010001
 111000000000000000111111             1000000001
    100000000000010000001              10011001
111100000010000000000000011111111111111100000001111111111
111111111111111111111111111111111111111111111111111111111