NO ./textures/north.png
SO ./textures/south.png
WE ./textures/west.png
EA ./textures/east.png

F 220,100,0
C 255,255,255


1111111111111111111
1000000000000000001
 1000011000E0000001
  11000000000000001
   1100000000000001
   1111100111111111
   1001100000000001
  11001110000000001
 100001100000010001
1000000000000111001
1111111111111111111