NO ./textures/north.png
SO ./textures/south.png
WE ./textures/west.png
EA ./textures/east.png

F 220,100,0
C 255,255,255


     1111    11
11111000011110011
10000000000000011
10000000000000011
1110000000000111
  11000000000011
   10000000000011
  1100000N0000001
  100000000000011
 100000000000011
 10000000000011
 1111100000001
      10000001                1111111111
     10000001                 1000000011
   110000001                  1000110001
  10000001111111111           1001  1001
  111000000000000011111       1001  1001
     10000000000000000111111111001100001
      1000111111110000000000000000000111
       10001     11111111111111111111111
        10001
       1100011
     111100001
     100000001
     100111001
     100101001
     100111001
     100000001
     111111111