NO ./textures/north.png
SO ./textures/south.png
WE ./textures/west.png
EA ./textures/east.png

F 220,100,0
C 255,255,255

1111111111111111111111111
1000000000111111111111111
1111111111111111111111111
1011000001110000000000001
100100000000000000000000111111111
111111111011000001110000000000001
100000000011000001110011111111111
111101111111110111000000100011
11110111111111011101000011111
1100000011010101110000S011111
10000000000000001100000011111
10000000000000001101010011111
11000001111111111111011110001
11110111         101111010001
11111111         111111111111